111111111111111111111
111111211111111111111
111100000000000000111
110000000000000000011
111000000000000000011
111000000000000000011
111000000000000000011
111100000000000000011
111100000000000000111
111111311111113111111
111111111111111111111
-
0,1,2,3
6,0,0,3
12,0,0,3
24,1,0,4
30,0,0,2
40,1,0,5
-
2,0,0,4
2,0,1,4
10,0,0,6
20,1,1,10
