1111111111111111
1000000000000001
1020000000000201
1000000000000001
1000000000000001
1000000000000001
1000000000000001
1000000000000001
1000000000000001
1000000000000001
1000000000000001
1000000000000001
1000000000000001
1030000000000301
1000000000000001
1111111111111111
-
0,1,0,5
0,0,0,5
5,1,1,5
5,0,1,5
10,1,2,5
10,0,2,5
15,1,3,5
15,0,3,5
-
0,1,0,1
1,0,0,1
2,1,1,1
3,0,1,1
4,1,2,1
5,0,2,1
6,1,3,1
7,0,3.1