111111111111111111111
111111211111111111111
111100000000000000111
110000000000000000011
111000000000000000011
111000000000000000011
111000000000000000011
111100000000000000011
111100000000000000111
111111111111113111111
111111111111111111111
-
0,2,0
0,3,2
0,3,4
1,2,8
0,2,10
1,2,12