11111111111111111111111
11113111111111111111111
11000111111100000000011
11000110100000000000011
11000110000000000100011
11000100000200000100011
11000100000000001100011
11000000000000011100011
11000000000111111100011
11111111111111111131111
11111111111111111111111
-
0,1,0,3
6,0,0,3
12,0,1,2
14,1,1,2
20,0,2,1
30,0,0,8
40,0,1,2
-
2,1,1,3
6,0,1,3
12,0,2,3
20,1,0,5
20,0,0,5
30,1,0,10
