111111111111111111
111211111111013111
110000111111000011
110000001000000011
110000001000000011
110000001000000011
110000000000000011
110000000000000011
110000001000000011
110000001000000011
110000001000000011
110000111111000011
111211111111113111
111111111111111111
-
0,1,0,6
0,0,0,6
12,1,1,1
12,0,1,2
20,1,2,2
27,0,2,1
35,0,0,6
35,1,0,6
-
0,1,0,3
5,0,0,3
10,0,2,4
15,0,1,3
15,1,0,6
20,1,1,3
25,0,1,3