111111111111111111
111111111111311111
110000000000000011
110000000000000011
110000000000000011
110000000000000011
110000011000000011
110000011100000011
110000111100000011
112000111110000011
110000111110000011
111000111111000011
111111111111113111
111111111111111111
-
0,1,0,6
0,0,0,6
12,1,1,1
12,0,1,2
20,1,2,2
27,0,2,1
35,0,0,6
35,1,0,6
-
0,1,0,3
5,0,0,3
10,0,2,4
15,0,1,3
15,1,0,6
20,1,1,3
25,0,1,3