1111111111111111
1000000000000001
1020000000000201
1000000000000001
1000000000000001
1000000000000001
1000000000000001
1000000000000001
1000000000000001
1000000000000001
1000000000000001
1000000000000001
1000000000000001
1030000000000301
1000000000000001
1111111111111111
-
0,1,0,1
0,0,0,1
5,1,1,1
5,0,1,1
10,1,2,1
10,0,2,1
20,0,0,4
20,1,0,4
-
0,1,0,1
1,0,0,1
2,1,1,1
3,0,1,1
4,1,2,1
5,0,2,1