111111111111111111111
111111211111111111111
111100000000000000111
110000000000000000011
111000000000000000011
111000000000000000011
111000000000000000011
111100000000000000011
111100000000000000111
111111311111113111111
111111111111111111111
-
0,1,0,3
6,0,0,3
12,0,1,2
14,1,1,2
20,0,2,1
30,0,0,8
40,0,1,2
-
2,1,1,3
6,0,1,3
12,0,2,3
20,1,0,5
20,0,0,5
30,1,0,10
